districtID,totalPop,male,female,medianAge,18andOver,65andOver,singleRace,black,nativeAmericanAlaskan,asian,pacificIslander,otherRace,multiRace,hispanic,nativeBorn,foreignBorn,
alabama1,344543,370803,40.3,552917,127083,702333,196891,6992,10627,183,7691,13013,24141,693956,21390,
alabama2,678122,326346,351776,38.8,524810,115362,663115,217977,2838,7442,26,8158,15007,24953,659525,18597,
alabama3,708409,345941,362468,39.2,554393,119519,695576,183949,1300,13049,0,6291,12833,22102,688990,19419,
alabama4,686297,336349,349948,40.5,530790,128143,670732,51171,4391,3072,677,20337,15565,44731,662635,23662,
alabama5,725634,359028,366606,39.5,567616,119725,706273,130913,3123,12215,160,19959,19361,38726,695444,30190,
alabama6,713595,346642,366953,40.0,552559,119052,697348,109254,1512,13683,545,15654,16247,33522,681800,31795,
alabama7,660468,310422,350046,36.4,515681,100779,651483,416885,1907,5007,206,5937,8985,23310,642954,17514,
alaska1,382952,354486,34.9,553978,88000,675242,25197,111371,46381,7958,9780,62196,53069,676654,60784,
arizona1,388546,381846,38.4,592187,148829,741752,19319,180970,11798,1188,24250,28640,177124,722968,47424,
arizona2,724747,357878,366869,40.9,582856,157202,688737,28469,13349,21765,1139,39945,36010,211844,646802,77945,
arizona3,798359,401906,396453,32.4,586774,99419,762857,40208,40005,16746,2281,99418,35502,506933,628244,170115,
arizona4,809426,405816,403610,48.5,658309,224318,782681,14247,11383,11679,2348,19206,26745,160649,750466,58960,
arizona5,841344,412423,428921,38.2,623120,141143,811278,35213,10581,41526,1031,22035,30066,146748,759540,81804,
arizona6,783621,386905,396716,42.7,627417,149354,757829,26842,12702,35839,838,18430,25792,140297,676796,106825,
arizona7,854749,427152,427597,29.1,595184,60596,818685,82671,30209,19817,176,78407,36064,548361,637696,217053,
arizona8,794820,381950,412870,43.2,626839,183219,764523,39285,6764,33004,2259,26855,30297,160989,719789,75031,
arizona9,794188,402553,391635,34.1,636961,95023,756324,50086,24636,45699,4401,45142,37864,213397,669070,125118,
arkansas1,359868,364754,39.5,557175,131155,697115,122626,2554,2796,171,7266,27507,24769,712043,12579,
arkansas2,765124,369461,395663,37.7,589069,121838,745413,174846,4030,13008,868,12113,19711,40484,733277,31847,
arkansas3,819235,404966,414269,35.5,618462,118046,793628,25638,9847,25283,7769,45288,25607,120730,743311,75924,
arkansas4,704844,342385,362459,41.0,545159,136637,689468,133604,4520,6461,590,20250,15376,44317,681485,23359,
california1,357637,353645,42.8,573300,155882,674378,12691,11320,19443,882,24748,36904,98995,670568,40714,
california2,722370,357376,364994,44.4,578755,153503,683625,11236,15063,31398,1003,49361,38745,130024,629650,92720,
california3,748104,370187,377917,34.9,570949,107218,699133,42954,8233,87457,7200,40541,48971,223566,609842,138262,
california4,754525,377608,376917,44.1,599447,159881,717767,10014,4749,43292,1624,21489,36758,107905,679052,75473,
california5,730955,359113,371842,40.7,580764,130207,691525,47271,5791,83384,2829,98453,39430,213555,572738,158217,
california6,777985,380830,397155,34.0,585378,95748,716643,99593,5130,128292,11778,85618,61342,224299,584864,193121,
california7,753640,368543,385097,38.9,584378,120191,697317,55737,6801,120343,6811,32841,56323,139092,603915,149725,
california8,717107,361408,355699,35.3,523964,96973,683694,61955,12982,23511,2262,47100,33413,292229,617099,100008,
california9,775148,380595,394553,35.2,564922,103224,691244,69964,5821,116574,3279,55875,83904,304076,601520,173628,
california10,761485,380532,380953,35.0,560216,98883,716653,24578,6704,54882,5838,51190,44832,341074,611906,149579,
california11,762290,372843,389447,40.0,599988,127281,710352,65509,4286,115716,3689,101498,51938,203319,559665,202625,
california12,764043,391594,372449,37.9,662533,116214,715266,39056,2208,249380,1750,57825,48777,109698,515436,248607,
california13,764304,369844,394460,36.7,624932,108061,708480,126848,5142,161671,5356,97130,55824,168664,565230,199074,
california14,759415,378809,380606,40.1,613658,125644,708146,21827,2455,266053,9036,80155,51269,176159,475688,283727,
california15,789174,391330,397844,38.4,604628,106877,739380,40917,3911,283643,9036,87236,49794,176316,513299,275875,
california16,749967,378254,371713,30.5,527163,78134,722768,39188,8028,69456,1664,182392,27199,460662,565663,184304,
california17,777468,404033,373435,36.4,617687,96078,740981,16541,3322,437632,1819,58748,36487,123567,391858,385610,
california18,750295,375370,374925,40.0,585243,116195,713316,16550,2638,180901,677,38312,36979,123135,522708,227587,
california19,763028,379974,383054,36.8,590197,102973,719514,23279,5242,222621,5519,128629,43514,302495,493835,269193,
california20,739352,370199,369153,35.1,560525,103980,707525,14945,7779,40200,2653,213127,31827,400149,544652,194700,
california21,713625,375964,337661,30.4,498817,64614,692702,30157,7915,28192,1368,114712,20923,530114,506599,207026,
california22,771095,377846,393249,32.6,549984,99343,732903,26578,9579,62678,729,109998,38192,378325,632381,138714,
california23,747852,380613,367239,34.7,545868,98579,714146,44943,7917,38586,1575,62353,33706,313758,637623,110229,
california24,738707,371237,367470,36.1,588511,127463,706085,14494,8054,35385,735,42148,32622,271396,603330,135377,
california25,716257,352672,363585,37.1,532181,93789,678404,52356,4779,61896,1139,104617,37853,290118,569037,147220,
california26,728927,362214,366713,37.9,559174,111657,696031,14078,4552,49488,1406,36272,32896,334782,569146,159781,
california27,705509,339827,365682,41.4,566944,127057,676948,28424,2216,282449,945,96228,28561,196507,429574,275935,
california28,709450,348013,361437,40.5,600523,110736,677874,15673,3765,92452,489,76475,31576,167571,430443,279007,
california29,707741,355538,352203,35.3,547435,82368,687654,27739,4958,56157,1385,208277,20087,476581,404004,303737,
california30,766513,375891,390622,39.2,617691,119121,728684,38904,3759,105314,533,104928,37829,219514,512533,253980,
california31,751527,368078,383449,33.4,553659,88386,711963,76166,3930,54119,4024,101105,39564,408571,598895,152632,
california32,716199,348260,367939,37.0,554860,96564,655052,19399,9652,133003,3683,119936,61147,449372,468739,247460,
california33,704818,345390,359428,40.8,571323,132040,660643,29120,2800,99123,630,22895,44175,96694,541584,163234,
california34,748812,384917,363895,35.3,610324,93848,723523,44238,9874,151348,1538,256530,25289,454579,408360,340452,
california35,769589,382031,387558,32.1,571198,74498,735572,42948,7224,57508,791,285674,34017,555178,537745,231844,
california36,752138,377080,375058,44.3,606006,171562,728648,34742,7241,31560,1644,153319,23490,352652,597325,154813,
california37,738174,362793,375381,35.4,596845,92876,707478,153069,6731,78857,1491,111987,30696,303939,495699,242475,
california38,716331,351312,365019,37.3,557180,107550,692376,26545,5145,122674,3907,242005,23955,439296,502919,213412,
california39,726541,354671,371870,38.4,568249,111862,695543,19667,5376,238123,919,64951,30998,242318,492050,234491,
california40,716470,360732,355738,32.3,521975,67423,699198,32673,4818,16858,721,233635,17272,627822,423386,293084,
california41,775626,381077,394549,31.0,568074,73535,742944,69240,4023,52523,1350,226903,32682,485439,582636,192990,
california42,826801,416463,410338,34.8,595541,99510,784410,51664,5827,72564,2543,122252,42391,343578,666223,160578,
california43,753696,365298,388398,35.8,576853,92544,723173,160048,4743,104116,2583,143823,30523,364583,511074,242622,
california44,725177,354717,370460,32.7,523521,75324,705462,111873,4247,36898,7805,223763,19715,519448,494768,230409,
california45,797608,390442,407166,39.5,626150,122823,757484,12515,2200,203292,1134,42404,40124,159203,564493,233115,
california46,735139,369917,365222,32.7,554465,74590,717724,16625,4291,87238,906,188633,17415,496851,461119,274020,
california47,710853,350075,360778,37.5,563394,91255,678993,54180,4766,164178,5794,86152,31860,242234,512822,198031,
california48,719486,357234,362252,42.6,584560,127774,686738,12424,2217,146976,2095,63570,32748,148913,540864,178622,
california49,731513,365247,366266,39.5,570223,122829,693385,21682,3291,58447,2834,34788,38128,183459,598736,132777,
california50,751551,372451,379100,37.5,574550,112208,714725,17983,8873,37033,4939,44964,36826,246319,607503,144048,
california51,747510,378733,368777,33.2,558662,88372,721661,51898,4579,59053,3125,99723,25849,532365,495315,252195,
california52,767172,393839,373333,37.0,616348,112620,719998,27211,3142,153271,2180,28270,47174,115282,593985,173187,
california53,796701,396902,399799,34.9,631792,99470,746752,63941,2703,114377,4094,47671,49949,274402,610967,185734,
colorado1,420311,421186,35.1,676675,100994,810034,65739,7236,29889,1253,46922,31463,227592,731973,109524,
colorado2,812357,408573,403784,37.7,655225,122089,783875,7708,3519,25225,265,13391,28482,92806,745959,66398,
colorado3,753595,377844,375751,40.4,590804,140186,737554,7103,17765,6997,160,30019,16041,187724,707079,46516,
colorado4,836061,424597,411464,37.3,628396,116803,807232,13167,5711,20314,1339,16855,28829,178614,774173,61888,
colorado5,815466,417279,398187,36.0,627818,115313,767361,48818,6866,21569,2631,26409,48105,135271,761388,54078,
colorado6,835273,415318,419955,37.0,629193,101182,795042,81416,7607,51858,1486,38133,40231,177001,712053,123220,
colorado7,801315,400839,400476,36.4,620715,111288,766996,13627,6442,24425,451,25102,34319,236119,713758,87557,
connecticut1,346571,368478,40.4,564374,124852,688275,111042,1420,38270,404,40166,26774,125592,609040,106009,
connecticut2,699657,348287,351370,42.5,570870,126055,671959,29961,2344,24302,46,18801,27698,61938,647443,52214,
connecticut3,712272,344386,367886,39.9,576540,124880,690928,104950,1242,32902,64,37368,21344,114435,618769,93503,
connecticut4,739090,359249,379841,40.6,570480,115192,715289,89713,1848,44292,327,52346,23801,146040,575234,163856,
connecticut5,706597,342040,364557,41.9,555335,122168,684824,55886,2653,26089,176,46527,21773,141805,601917,104680,
delaware1,467924,499247,41.1,764021,180756,941343,217594,4397,39023,896,19652,25828,91975,875941,91230,
district_of_colombia1,334208,368247,33.9,575241,85626,677288,319777,1932,27538,397,30897,25167,79249,604609,97846,
florida1,393809,390723,38.9,616082,132405,750271,106063,4133,22245,1815,14200,34261,53522,739231,45301,
florida2,733749,374666,359083,42.2,591453,148454,711014,92184,3345,12107,579,15539,22735,49645,696460,37289,
florida3,758275,374082,384193,37.7,601561,128208,732886,127519,1709,25902,426,11718,25389,79676,696741,61534,
florida4,819177,406302,412875,40.1,648028,137230,792582,74267,2692,36847,65,15921,26595,72602,725340,93837,
florida5,738862,353345,385517,34.7,569060,98265,716135,351034,2734,20493,344,9945,22727,64891,680069,58793,
florida6,781896,380007,401889,47.6,641342,200306,768302,82045,2596,14167,120,28067,13594,104987,718048,63848,
florida7,786041,385458,400583,36.8,632447,114061,760679,87476,1127,42337,619,46104,25362,211449,656234,129807,
florida8,768139,372615,395524,48.5,631073,195565,738736,72300,2505,16407,875,7354,29403,87477,702420,65719,
florida9,902812,438531,464281,38.3,702786,145575,870756,111993,2464,27123,16,58851,32056,386712,755397,147415,
florida10,839504,409639,429865,35.3,636002,97785,812336,237772,3835,41302,930,49281,27168,238792,633733,205771,
florida11,789849,381162,408687,55.7,668896,281669,771737,55539,2713,8909,31,10931,18112,89397,736317,53532,
florida12,792410,376610,415800,46.6,637648,193965,766744,38884,2834,20897,588,16698,25666,107036,706500,85910,
florida13,735935,360038,375897,47.4,618898,171584,710853,91631,2073,26641,756,9233,25082,78500,649079,86856,
florida14,782973,384896,398077,36.3,611438,104514,743216,140825,1824,35850,0,32896,39757,249606,612105,170868,
florida15,808723,397047,411676,38.3,629350,132949,782201,127840,3034,24983,379,27821,26522,185313,697015,111708,
florida16,852096,409284,442812,47.9,691520,226843,832416,75971,2196,19208,480,25385,19680,157171,733512,118584,
florida17,789236,389995,399241,51.5,650277,255782,772023,56190,1324,10685,497,22463,17213,130252,708035,81201,
florida18,780772,377473,403299,48.2,641313,201423,756908,104795,381,17963,525,21936,23864,128302,659459,121313,
florida19,836359,410630,425729,51.5,698285,264638,825958,67922,1118,15582,491,29364,10401,173271,682529,153830,
florida20,809153,392337,416816,36.2,616056,108899,781759,434883,849,25202,1087,24194,27394,209094,521767,287386,
florida21,785042,378173,406869,45.9,641615,201501,767067,120536,2249,22923,441,19391,17975,198016,563467,221575,
florida22,753363,375200,378163,45.7,617829,165568,733804,111541,1591,22493,446,21940,19559,165952,545526,207837,
florida23,756447,361211,395236,41.4,593860,137835,727712,110474,3817,35644,710,43865,28735,299664,473139,283308,
florida24,784469,380877,403592,36.8,609742,107971,769199,371721,354,11669,112,48308,15270,331349,439499,344970,
florida25,775326,380136,395190,42.6,630173,147636,765227,36179,1050,8252,0,22569,10099,585299,343774,431552,
florida26,790373,389059,401314,39.2,616295,117449,774439,87276,5058,12069,509,45302,15934,568892,402644,387729,
florida27,763812,372094,391718,41.9,628421,140704,750440,35881,265,15734,0,29464,13372,555585,345854,417958,
georgia1,364112,380273,36.1,570138,109215,715480,217918,1520,11663,3137,13521,28905,50819,708697,35688,
georgia2,665539,327152,338387,37.0,510900,105503,645287,340276,1289,7641,540,13586,20252,36737,642685,22854,
georgia3,740700,361367,379333,39.0,565260,114866,723728,188551,3992,16496,894,14394,16972,45194,702910,37790,
georgia4,785104,373317,411787,36.3,591573,95657,768640,472419,1285,49178,2848,31949,16464,76482,643447,141657,
georgia5,793039,380694,412345,32.9,625191,86695,769718,466017,1970,30640,510,19305,23321,52678,721432,71607,
georgia6,754299,378191,376108,39.1,574849,98851,732483,98130,7170,96303,356,11749,21816,93027,591664,162635,
georgia7,803976,390013,413963,36.4,587891,84707,778584,162756,6148,114858,45,60675,25392,158430,594471,209505,
georgia8,714720,351303,363417,36.9,545992,109323,699853,224512,2424,13368,103,12973,14867,46945,682669,32051,
georgia9,765320,375786,389534,40.7,593571,142766,748239,46909,1485,9854,1947,15476,17081,101876,703277,62043,
georgia10,767352,376255,391097,37.2,587368,110981,751295,200069,1096,16337,237,17677,16057,46502,723053,44299,
georgia11,781313,379352,401961,36.7,600386,102184,758822,130277,1696,29460,1934,24954,22491,84514,699314,81999,
georgia12,723334,355303,368031,35.6,554787,102894,702414,252862,789,13873,1279,16403,20920,46212,692886,30448,
georgia13,757521,352704,404817,36.1,560019,85526,731981,451182,1201,21403,128,37993,25540,97758,675082,82439,
georgia14,722873,354741,368132,38.7,548257,107260,706545,67813,2420,4977,91,10493,16328,84580,673815,49058,
hawaii1,357360,351926,39.9,565797,132970,550455,17088,628,351660,52637,5985,158831,66279,545844,163442,
hawaii2,711205,353342,357863,38.8,551439,128497,524261,11237,2609,182819,92334,12067,186944,85077,608500,102705,
idaho1,457663,455287,38.5,687493,155498,884757,6900,14043,13943,2030,32623,28193,99625,861674,51276,
idaho2,841258,424495,416763,35.0,621345,123943,816196,5175,8983,13083,733,26594,25062,122839,787306,53952,
illinois1,333301,373249,39.1,551914,112861,694812,354097,301,17443,103,19255,11738,75300,649831,56719,
illinois2,694459,321210,373249,37.9,524592,111159,680695,393578,1139,6314,95,25713,13764,103443,637454,57005,
illinois3,704050,350554,353496,38.7,538288,108168,688578,35460,3459,31306,158,63289,15472,228203,559949,144101,
illinois4,702062,352971,349091,33.9,534143,71791,682161,28977,3538,24719,188,204348,19901,475571,489031,213031,
illinois5,743699,367389,376310,35.5,608378,95746,717388,22900,1120,63328,187,35743,26311,138791,579602,164097,
illinois6,730345,360402,369943,41.5,561679,119204,710120,17193,955,72910,64,18100,20225,73998,619634,110711,
illinois7,707513,341185,366328,35.0,573343,96514,689869,323450,1095,52122,148,48385,17644,124242,610516,96997,
illinois8,707268,341723,365545,37.0,539778,97618,688398,38308,6590,99254,1736,87930,18870,212650,498879,208389,
illinois9,721481,355134,366347,40.3,564037,126337,695648,68026,1847,95553,771,22005,25833,81079,541135,180346,
illinois10,711265,353539,357726,38.3,544615,109894,691519,44334,3364,82379,422,67579,19746,169408,528525,182740,
illinois11,722584,357375,365209,36.8,543809,90133,692903,76321,3335,58102,418,58508,29681,210124,579852,142732,
illinois12,687072,341016,346056,39.9,536794,117968,669726,117582,1329,8924,110,8331,17346,21908,669600,17472,
illinois13,704211,348155,356056,36.3,563118,111496,686934,77759,1086,31373,0,5983,17277,26122,664354,39857,
illinois14,742235,373029,369206,39.4,552219,102747,720284,28485,1023,28809,186,15912,21951,97239,672362,69873,
illinois15,691196,346943,344253,41.3,537759,133930,679037,31004,1228,3770,282,2998,12159,18636,679033,12163,
illinois16,684888,343108,341780,41.5,539031,124590,669479,25648,1341,11044,176,11562,15409,70798,647500,37388,
illinois17,679926,336379,343547,40.4,529554,126888,657739,80141,1776,10393,245,11838,22187,60034,649371,30555,
illinois18,700276,342649,357627,40.9,542227,133504,684813,29816,1320,20195,28,5299,15463,21322,673139,27137,
indiana1,352539,362217,39.4,553329,118463,688466,130246,1822,9931,405,53964,26290,113541,673247,41509,
indiana2,723483,357600,365883,37.8,546196,118817,700128,49889,2915,9346,504,21096,23355,73761,681452,42031,
indiana3,747060,370187,376873,37.1,556270,115773,725261,45994,2183,17695,630,12431,21799,46403,712203,34857,
indiana4,768025,387277,380748,37.2,594483,118000,750981,31603,1826,24154,120,14054,17044,48814,724915,43110,
indiana5,784462,379112,405350,38.2,596192,116399,761285,67551,1022,31488,466,9337,23177,37508,731845,52617,
indiana6,719771,355251,364520,39.5,562170,127419,706582,20547,731,12177,317,3867,13189,20114,697422,22349,
indiana7,760466,367928,392538,33.9,566389,92272,736376,235061,1900,24608,534,36106,24090,87750,687776,72690,
indiana8,718591,356674,361917,39.9,558736,124660,706249,34314,407,5948,148,5930,12342,18872,702872,15719,
indiana9,755264,369405,385859,37.6,591056,119343,735909,22072,1234,18873,346,5518,19355,25656,725798,29466,
iowa1,383408,390220,38.8,597488,139220,760077,32960,4341,14447,1669,5068,13551,32452,742253,31375,
iowa2,783983,388231,395752,38.0,605811,134426,764019,32975,1578,18719,785,9563,19964,46049,740714,43269,
iowa3,843598,416127,427471,37.0,634262,123357,821900,36515,1985,29566,478,9957,21698,59471,779923,63675,
iowa4,754936,377122,377814,38.9,585195,140815,740881,12687,3590,17239,531,6125,14055,53501,718118,36818,
kansas1,353292,345031,36.0,531809,115910,676980,22787,3875,11136,533,16097,21343,113508,645983,52340,
kansas2,713845,354493,359352,37.9,552616,123084,683484,34044,11963,11689,255,7788,30361,48603,689853,23992,
kansas3,775243,382093,393150,37.1,580447,108784,749053,62214,2399,38097,1615,25315,26190,95844,694041,81202,
kansas4,724099,359867,364232,37.1,541487,114413,693942,52096,8592,21522,526,24093,30157,90488,672271,51828,
kentucky1,355534,365590,40.6,559063,133233,703068,49665,1301,4625,1714,4621,18056,21680,709113,12011,
kentucky2,769850,382270,387580,38.6,591524,124068,747803,35956,2452,13122,2735,8462,22047,25454,743245,26605,
kentucky3,749110,361301,387809,38.3,583435,120473,730388,167681,1894,22504,27,12743,18722,43817,688104,61006,
kentucky4,754387,374042,380345,39.3,577207,116906,738229,25869,849,8646,213,9340,16158,25598,732100,22287,
kentucky5,695105,344010,351095,40.8,540810,121959,688162,8772,982,1749,150,2106,6943,7561,689391,5714,
kentucky6,778826,381864,396962,37.1,608582,114753,752734,66818,992,14654,104,14615,26092,37396,737103,41723,
louisiana1,396410,410228,38.7,622019,130195,788028,112895,10809,20878,173,9225,18610,71074,751174,55464,
louisiana2,794121,379129,414992,37.5,614277,115542,778452,491080,1885,16320,111,21215,15669,56176,743718,50403,
louisiana3,783545,382518,401027,36.8,590907,115222,767320,197823,2586,10513,0,4487,16225,32653,759758,23787,
louisiana4,747314,370579,376735,37.2,568108,122592,730187,257496,5155,7916,538,11046,17127,29762,729967,17347,
louisiana5,738249,366678,371571,37.8,561479,121256,724597,262847,2490,5278,135,5750,13652,15650,726558,11691,
louisiana6,790111,381216,408895,36.0,605603,115803,766349,187266,2732,15350,176,13643,23762,34639,753776,36335,
maine1,334199,351336,44.5,558051,138926,670829,11986,1909,11378,444,2476,14706,12892,656222,29313,
maine2,652869,321535,331334,45.6,531801,137143,637556,6968,6657,4305,21,788,15313,9519,634764,18105,
maryland1,363209,378412,42.7,582989,138984,722178,91106,996,15601,260,9267,19443,31974,707003,34618,
maryland2,768511,364768,403743,37.1,595771,109606,737456,272284,1475,41651,440,15739,31055,51397,679289,89222,
maryland3,754636,366630,388006,37.3,593065,115494,727157,173443,2041,57822,174,28615,27479,67780,628495,126141,
maryland4,760398,364951,395447,38.0,580239,103193,733745,397886,1055,24360,187,98434,26653,131619,602644,157754,
maryland5,757621,370907,386714,38.7,592774,105734,729240,294783,2690,32124,0,40980,28381,75797,665055,92566,
maryland6,758943,377702,381241,39.2,584385,118748,727312,103706,1618,81520,1162,34577,31631,110002,606705,152238,
maryland7,716136,338992,377144,38.5,564946,113001,694174,374252,1811,52833,4539,8977,21962,34379,633443,82693,
maryland8,784852,383191,401661,39.9,610194,126281,748441,103425,1747,73074,549,67453,36411,125487,604893,179959,
massachusettes1,354186,382295,41.0,585579,132153,716582,51375,1622,15458,189,21554,19899,138855,682551,53930,
massachusettes2,745347,365205,380142,39.9,602102,121700,719517,39762,1346,45415,618,18667,25830,77102,641819,103528,
massachusettes3,771096,382432,388664,39.2,598497,105527,745285,32434,2247,58988,198,78451,25811,150515,631617,139479,
massachusettes4,766019,365816,400203,41.3,597133,127736,746114,26402,1147,50401,127,16664,19905,39516,656921,109098,
massachusettes5,775135,378519,396616,39.1,626645,125377,747388,43210,424,99306,181,22274,27747,76232,581774,193361,
massachusettes6,780524,374955,405569,43.0,621414,146196,759854,34650,1015,37038,375,27056,20670,83856,662310,118214,
massachusettes7,820086,396239,423847,31.7,683622,89349,763994,198972,4105,88517,772,57732,56092,186622,560595,259491,
massachusettes8,764891,375363,389528,39.2,618753,124671,744916,85908,1504,66187,162,25469,19975,46510,621924,142967,
massachusettes9,742570,358172,384398,45.6,601278,164832,723755,24810,2788,11093,153,35464,18815,47572,664490,78080,
michigan1,356045,343175,46.7,570934,163475,678528,9447,17771,5169,366,2083,20692,13320,684641,14579,
michigan2,743361,367463,375898,37.4,572043,119587,718462,49717,5025,19487,298,18877,24899,70506,699824,43537,
michigan3,749975,374990,374985,36.9,569489,112791,722054,61116,2878,15348,346,14900,27921,59860,711548,38427,
michigan4,704592,351695,352897,41.6,561588,137477,689692,13239,5200,7785,193,3736,14900,23557,689850,14742,
michigan5,671115,326172,344943,41.8,524805,124550,649389,117802,2293,5568,66,4129,21726,33836,657964,13151,
michigan6,721736,356681,365055,38.9,559763,124855,692107,58328,3136,11341,573,11033,29629,46202,688283,33453,
michigan7,706811,353841,352970,42.0,555530,130623,687945,28719,1947,7418,86,5080,18866,31975,687740,19071,
michigan8,749011,368620,380391,38.1,583935,112636,725792,43581,2612,37707,146,6424,23219,40479,688517,60494,
michigan9,715259,349510,365749,39.6,576801,119353,697816,103803,2686,30799,247,3152,17443,17951,638081,77178,
michigan10,722722,359275,363447,43.5,567533,132553,707946,21764,1742,14989,392,4435,14776,25031,673950,48772,
michigan11,733920,361375,372545,41.7,577109,123503,713187,37402,1773,80740,44,6560,20733,24140,623849,110071,
michigan12,709832,353009,356823,35.3,563615,103976,686612,80720,2273,42832,230,11542,23220,43833,618712,91120,
michigan13,663867,315738,348129,36.7,501267,97265,647390,356197,2240,9414,248,18839,16477,52763,611509,52358,
michigan14,704494,332402,372092,38.6,547238,117809,686330,394916,1436,37231,672,7677,18164,33928,626230,78264,
minnesota1,340122,338296,38.6,522083,117573,664051,21905,2013,18839,1141,13714,14367,46054,633630,44788,
minnesota2,714141,350825,363316,37.9,538088,99093,691592,40131,3444,33434,66,13112,22549,45305,647375,66766,
minnesota3,723994,353270,370724,40.4,552571,114683,699772,63310,1360,55202,339,10189,24222,29677,634849,89145,
minnesota4,717766,351638,366128,36.2,547240,104637,686212,75003,4597,92962,155,13045,31554,48079,619340,98426,
minnesota5,718802,358830,359972,33.7,569735,91072,687974,122385,9613,42670,70,29171,30828,68067,608105,110697,
minnesota6,722715,366854,355861,37.5,541574,94077,704680,26704,2829,19476,33,8805,18035,25002,680215,42500,
minnesota7,663069,330867,332202,40.3,506770,130239,648498,11246,19132,5728,308,12271,14571,33729,641318,21751,
minnesota8,672274,341574,330700,43.4,531071,137260,653568,6969,17995,4815,284,2507,18706,12100,662155,10119,
mississippi1,370895,398700,38.3,588899,121547,753288,213965,1791,4848,110,12688,16307,25696,750740,18855,
mississippi2,695797,334753,361044,37.3,527456,106751,691228,465342,2068,1403,115,3769,4569,12593,688002,7795,
mississippi3,746155,359679,386476,37.5,572733,122887,739130,272635,7793,8992,509,4314,7025,15224,724630,21525,
mississippi4,774983,381502,393481,37.7,591720,123238,757934,183657,1582,10899,638,9007,17049,33613,752298,22685,
missouri1,346255,382110,36.3,573137,106576,707476,359940,1370,22653,566,7063,20889,24864,682804,45561,
missouri2,760689,367096,393593,42.8,595267,143830,744814,29119,1685,40337,665,3084,15875,21247,699950,60739,
missouri3,793405,393152,400253,39.2,612022,128004,776515,28334,1643,6692,903,2889,16890,19356,772189,21216,
missouri4,770500,385142,385358,37.2,599536,130398,744581,33920,5257,13518,350,4827,25919,30694,741805,28695,
missouri5,771847,373445,398402,36.8,596778,119698,742337,170287,2174,12887,3029,23087,29510,71048,723939,47908,
missouri6,780002,387329,392673,38.6,593139,128534,756215,33495,3588,9883,348,6153,23787,31814,755805,24197,
missouri7,783672,383138,400534,38.4,605946,138312,759034,16109,8968,9339,1376,7741,24638,41219,763264,20408,
missouri8,737972,367608,370364,41.3,572901,139722,721616,33123,3020,6108,148,1713,16356,13232,728306,9666,
montana1,534782,527523,40.1,832340,200239,1029842,5056,68013,8517,990,5828,32463,41605,1038939,23366,
nebraska1,328828,324856,35.9,497142,99097,629624,18792,7691,17322,538,10706,24060,64232,608471,45213,
nebraska2,673005,332339,340666,35.2,497831,86041,652048,64342,4379,24168,90,14597,20957,78057,612976,60029,
nebraska3,602579,300046,302533,39.9,459409,118860,588635,8087,6485,4289,661,21170,13944,72194,568868,33711,
nevada1,345733,339694,36.9,533900,99661,654826,90137,12197,55672,3623,153447,30601,311043,480281,205146,
nevada2,729771,372103,357668,39.5,571402,126080,703870,14156,17657,29443,3918,60273,25901,168405,642740,87031,
nevada3,846761,420486,426275,39.2,663679,133739,791533,69957,4236,121484,4340,56812,55228,154616,678015,168746,
nevada4,772433,384052,388381,36.9,576191,115640,728333,106135,10576,43538,7731,88254,44100,247081,645670,126763,
new_hampshire1,336928,349892,41.7,554549,120363,670121,13242,1723,17936,222,4956,16699,25149,645683,41137,
new_hampshire2,669638,332514,337124,44.3,543781,124793,656380,10190,1839,18112,293,4057,13258,27499,627773,41865,
new_jersey1,353252,378045,39.0,568216,113725,708411,129837,822,40308,63,50696,22886,105997,658413,72884,
new_jersey2,703117,346593,356524,43.3,558954,136834,680258,84924,2140,26713,255,42124,22859,115945,631283,71834,
new_jersey3,742905,363096,379809,43.0,588516,142831,719968,83511,745,26661,603,20144,22937,66367,677339,65566,
new_jersey4,748858,362215,386643,42.2,570618,147151,738120,48584,648,38402,92,12716,10738,76789,654626,94232,
new_jersey5,730707,354658,376049,43.1,572549,131230,710824,38676,2251,79469,0,12348,19883,106341,580852,149855,
new_jersey6,730114,362648,367466,38.0,574560,105000,708249,81928,2515,135462,385,35906,21865,165414,516922,213192,
new_jersey7,730778,356651,374127,43.0,566968,120534,713509,36153,871,83376,126,19338,17269,93377,593231,137547,
new_jersey8,764837,382900,381937,34.7,599653,82392,735173,74690,5422,76486,0,169696,29664,424366,421133,343704,
new_jersey9,765382,376643,388739,38.6,595784,110980,745149,74660,1710,102269,536,112714,20233,295861,463878,301504,
new_jersey10,759704,365555,394149,36.1,584542,98861,741515,390745,1661,54128,241,75887,18189,160348,528426,231278,
new_jersey11,744805,359454,385351,42.6,586824,132036,728462,30778,621,77937,266,12989,16343,91285,602098,142707,
new_jersey12,756016,366721,389295,40.0,590331,116715,731483,133509,1725,127002,342,39776,24533,137269,547027,208989,
new_mexico1,343453,353611,38.5,551116,117458,666380,19749,29381,18398,176,47764,30684,350078,625776,71288,
new_mexico2,700113,351236,348877,36.8,529191,122410,684175,15287,39115,5840,690,37439,15938,390187,617476,82637,
new_mexico3,698251,344952,353299,39.2,534884,128612,677687,11028,132163,9917,1599,59758,20564,288964,653654,44597,
new_york1,357046,361680,42.3,566670,129004,702515,41995,1644,32067,148,10209,16211,114404,628001,90725,
new_york2,709605,346050,363555,40.8,559561,108985,689401,67496,3816,20864,435,41687,20204,169226,586015,123590,
new_york3,707576,344741,362835,45.9,563726,146620,691660,21650,892,125574,86,24909,15916,73370,541412,166164,
new_york4,729582,355474,374108,40.4,567895,125392,708227,111129,5570,53464,656,69259,21355,162277,555218,174364,
new_york5,757972,361166,396806,38.8,593639,110647,728961,379126,3641,110675,717,102284,29011,135856,435579,322393,
new_york6,734183,353451,380732,42.3,597591,130286,709789,28153,3609,292880,52,71968,24394,153419,354874,379309,
new_york7,720811,352133,368678,34.2,551809,84981,685283,73871,3175,121103,973,122882,35528,286681,485583,235228,
new_york8,791211,356607,434604,36.4,621053,118829,763568,404883,1929,49353,77,61137,27643,141315,527844,263367,
new_york9,730957,341274,389683,36.8,577058,110059,705746,347766,1889,57532,80,36135,25211,81623,445389,285568,
new_york10,711678,340996,370682,36.8,571862,114159,686465,22645,2626,134537,87,30890,25213,91548,489781,221897,
new_york11,732886,356897,375989,40.2,571539,123577,709186,58687,958,107802,350,42546,23700,134490,502602,230284,
new_york12,698928,334872,364056,35.8,620147,110208,675403,36314,2940,98828,541,30592,23525,86523,514033,184895,
new_york13,795633,379590,416043,35.6,636127,101638,743872,236352,8199,37783,428,257220,51761,438038,505970,289663,
new_york14,706440,356097,350343,36.9,557086,94455,680438,77660,3261,120878,0,179865,26002,356722,380354,326086,
new_york15,743959,351571,392388,32.1,542855,80341,712766,274909,5635,17342,1700,284182,31193,486485,476487,267472,
new_york16,732981,338664,394317,40.5,572198,127802,706203,239144,2789,36612,305,93276,26778,197260,511972,221009,
new_york17,741445,367580,373865,38.9,562143,124138,718090,77079,1040,47212,163,76114,23355,159483,577107,164338,
new_york18,722226,359634,362592,39.7,557161,110816,695996,71762,1710,21323,426,50516,26230,128645,631426,90800,
new_york19,700310,351564,348746,45.0,571852,144119,678353,35432,1955,11050,11,15319,21957,57945,655507,44803,
new_york20,722529,349913,372616,38.9,580696,123308,691395,69955,2447,37561,1054,12644,31134,49509,654013,68516,
new_york21,701112,362930,338182,41.6,562725,125887,689034,22513,5670,7630,512,8877,12078,24214,674817,26295,
new_york22,697372,344379,352993,41.0,554744,130497,682252,30253,1584,22291,111,8045,15120,27245,654698,42674,
new_york23,693764,345865,347899,40.7,557276,130512,677902,20315,4333,16129,214,10620,15862,28333,666173,27591,
new_york24,701664,343248,358416,40.2,555271,122161,681738,62932,3461,17694,105,5772,19926,32587,656900,44764,
new_york25,718565,345959,372606,38.9,568837,123290,696273,111729,3122,28244,171,15041,22292,66334,653613,64952,
new_york26,707190,338199,368991,38.5,563727,123251,681734,128856,2773,31890,22,21067,25456,49758,642049,65141,
new_york27,712904,355413,357491,44.5,572276,137103,702304,16653,3644,7795,0,6789,10600,19233,687627,25277,
north_carolina1,364971,396116,37.8,600553,126081,739530,330488,6460,16290,251,23023,21557,70296,703976,57111,
north_carolina2,858938,419435,439503,38.7,638159,117604,825583,159101,3663,19838,1081,32078,33355,90028,792206,66732,
north_carolina3,756375,386059,370316,37.9,591177,132134,728940,153235,3427,10733,641,12615,27435,61432,728900,27475,
north_carolina4,871589,419660,451929,35.3,686773,102109,839654,195920,3458,77259,283,37619,31935,89730,743174,128415,
north_carolina5,762960,371305,391655,41.5,603611,138964,748231,114729,4205,12012,1797,14266,14729,73619,715243,47717,
north_carolina6,772716,375109,397607,41.0,602123,136131,755678,158359,2592,14553,588,29388,17038,78637,717343,55373,
north_carolina7,809820,393260,416560,41.9,643129,160657,791564,154737,5022,6822,467,15679,18256,77660,760188,49632,
north_carolina8,797935,394779,403156,36.8,607866,119587,766283,180732,8295,21862,3111,26740,31652,88667,745023,52912,
north_carolina9,792434,384736,407698,39.2,593040,122555,772809,153740,61608,29200,438,17248,19625,63584,730651,61783,
north_carolina10,762919,364324,398595,42.4,603508,140903,746000,96167,1944,13014,302,19999,16919,50383,726964,35955,
north_carolina11,768166,377923,390243,45.6,624815,173932,751547,22893,10898,8484,555,14037,16619,51563,732306,35860,
north_carolina12,880550,423306,457244,34.0,676855,87139,856303,333074,4034,48882,309,64917,24247,136316,740230,140320,
north_carolina13,788131,377377,410754,39.2,615153,130778,763355,169358,5239,27733,395,19021,24776,63614,723239,64892,
north_dakota1,391222,368855,35.4,585363,116433,742510,25896,41270,13749,339,9569,17567,27444,724253,35824,
ohio1,364833,376146,37.4,566639,111917,717357,153148,1049,27695,0,6680,23622,26112,688383,52596,
ohio2,734712,355233,379479,39.3,567593,119527,717473,71218,1183,14023,1326,2967,17239,15103,710949,23763,
ohio3,812264,392688,419576,32.4,612979,84005,773156,276374,2310,37678,68,21435,39108,57550,702761,109503,
ohio4,707219,354005,353214,40.8,550176,123452,689291,35888,3610,8129,74,4479,17928,27388,693237,13982,
ohio5,717088,350558,366530,40.7,556664,130512,695508,18872,1250,9691,857,10590,21580,37722,698081,19007,
ohio6,694694,347597,347097,43.7,548138,139032,681080,15368,1304,3887,0,2074,13614,6563,687351,7343,
ohio7,734091,359617,374474,40.4,562727,135066,716033,28285,1645,4713,0,3780,18058,18719,720087,14004,
ohio8,731637,359483,372154,39.6,562030,123430,710441,44808,1248,16544,0,6862,21196,26611,701167,30470,
ohio9,716235,353828,362407,37.9,559047,112349,679557,112356,3161,10655,503,19485,36678,84049,684336,31899,
ohio10,725301,352360,372941,38.9,566809,128971,699878,121710,1847,17383,414,5073,25423,21916,692339,32962,
ohio11,678001,314509,363492,39.5,538929,119878,652949,355642,1791,17489,327,8207,25052,29751,641485,36516,
ohio12,789634,393211,396423,38.7,607397,123476,762902,36840,1594,36877,136,3733,26732,20689,741933,47701,
ohio13,707603,342793,364810,40.8,569647,132490,685488,82532,977,15332,37,5696,22115,26042,683798,23805,
ohio14,720551,353710,366841,43.9,566895,145548,706481,35441,569,16156,355,4629,14070,23393,680529,40022,
ohio15,759569,382574,376995,38.9,598278,120773,738945,36182,1063,19593,86,2709,20624,17367,727872,31697,
ohio16,719864,355096,364768,43.1,565058,145737,704505,21642,1071,15917,45,3737,15359,16943,679551,40313,
oklahoma1,391856,411173,36.5,601846,120002,742097,70321,48932,24819,391,18950,60932,94133,740234,62795,
oklahoma2,747632,370798,376834,39.8,573557,141541,668363,24525,133425,4307,1191,10733,79269,40658,732449,15183,
oklahoma3,778026,392012,386014,37.0,592156,125904,728507,30541,44811,10533,362,24589,49519,80140,740732,37294,
oklahoma4,791927,393860,398067,36.1,607573,118261,729254,52439,43374,18498,1156,21846,62673,73895,754077,37850,
oklahoma5,822465,401550,420915,35.0,611627,113893,771114,109854,36641,26537,759,33895,51351,140253,738705,83760,
oregon1,425122,433788,38.1,669145,127814,815790,18791,5374,69904,4836,33889,43120,128145,728573,130337,
oregon2,831343,415415,415928,42.4,653071,173438,801496,5956,15829,10435,1882,15377,29847,118199,775477,55866,
oregon3,841456,418141,423315,37.9,680020,114251,799695,42053,7899,66538,5304,12169,41761,97391,724958,116498,
oregon4,814998,403336,411662,41.2,663509,173359,772354,5543,10607,21313,1621,24402,42644,66962,767940,47058,
oregon5,844006,417929,426077,39.5,652380,150749,804156,9703,9342,22490,5115,52136,39850,145700,761355,82651,
pennslyvania1,351273,362412,43.8,569027,131951,697459,28311,551,45393,638,11729,16226,41311,636445,77240,
pennslyvania2,727380,349229,378151,35.3,549355,97633,699835,196199,2602,57767,315,109753,27545,190084,594387,132993,
pennslyvania3,736340,344031,392309,33.7,598696,101895,707654,407657,1523,44326,267,11151,28686,40023,664575,71765,
pennslyvania4,727449,354684,372765,41.2,570761,129655,707299,70160,305,47999,299,10186,20150,36269,652640,74809,
pennslyvania5,718076,343257,374819,38.1,558406,115180,699942,182343,1967,49895,0,5531,18134,33639,624194,93882,
pennslyvania6,734876,359769,375107,39.2,561879,117746,713817,48066,508,32630,0,32478,21059,115981,655387,79489,
pennslyvania7,731168,358892,372276,40.3,578135,130877,704615,52692,2117,23923,1022,32316,26553,142642,655351,75817,
pennslyvania8,696956,343402,353554,43.3,556796,136309,677637,41398,821,13750,462,19021,19319,86241,642884,54072,
pennslyvania9,702489,351698,350791,44.2,564312,140541,691028,19626,644,8666,137,18873,11461,49849,680849,21640,
pennslyvania10,734849,359880,374969,40.0,572564,126901,710827,85298,1534,28041,353,13980,24022,61607,685888,48961,
pennslyvania11,737394,364048,373346,40.1,569443,135491,720345,28887,1971,14129,493,18436,17049,69093,700581,36813,
pennslyvania12,701192,349828,351364,40.9,562461,134560,692077,14903,1746,13706,251,4106,9115,17337,680088,21104,
pennslyvania13,692835,342833,350002,44.3,553951,143768,676511,20284,729,3812,28,4340,16324,22858,676554,16281,
pennslyvania14,684084,335660,348424,45.7,554616,146513,671680,21422,380,6459,324,1309,12404,9612,672849,11235,
pennslyvania15,680927,347886,333041,44.5,554383,141099,670374,11851,792,5334,174,2896,10553,10122,670979,9948,
pennslyvania16,686525,337388,349137,42.6,547405,134058,670982,32918,1349,8556,63,4596,15543,18201,667115,19410,
pennslyvania17,717264,352802,364462,43.4,572579,139791,699281,43985,628,22145,25,3182,17983,13090,682566,34698,
pennslyvania18,683571,325060,358511,38.7,564674,128401,662152,122406,1251,28496,157,3689,21419,16804,641143,42428,
puerto_rico1,1520415,1674738,42.9,2601143,661216,3041937,400936,4013,5144,767,551773,153216,3154017,3109805,85348,
rhode_island1,260733,271857,39.5,428714,92707,514623,45855,1707,16633,723,42630,17967,100684,443259,89331,
rhode_island2,524725,255167,269558,40.3,424693,89938,509962,24894,2634,19431,160,17113,14763,67657,474993,49732,
south_carolina1,395270,414340,40.0,637589,147364,789157,154046,2094,15292,1334,20133,20453,54494,757342,52268,
south_carolina2,717231,349519,367712,38.7,553099,116090,700984,176461,1504,14979,171,13521,16247,44177,682193,35038,
south_carolina3,697467,343126,354341,41.0,549360,130586,681374,126928,1989,5646,231,11789,16093,36902,672171,25296,
south_carolina4,736750,356573,380177,38.2,568368,117625,716969,135926,5485,19469,1314,18275,19781,63356,674954,61796,
south_carolina5,731341,353760,377581,40.3,563276,123080,713673,194577,3419,9808,86,10826,17668,33024,704898,26443,
south_carolina6,659483,320260,339223,35.6,523469,104369,639587,361797,2260,7989,772,10462,19896,30569,632928,26555,
south_carolina7,732245,350199,382046,43.8,584557,160640,721186,203864,6921,7786,96,7974,11059,31980,702876,29369,
south_dakota1,445271,436964,37.2,667772,146358,858851,19057,78068,15023,51,5782,23384,33983,847060,35175,
tennesse1,352969,367389,43.9,578249,148230,707259,15508,2400,5702,972,4987,13099,28015,699233,21125,
tennesse2,753229,367457,385772,39.8,597154,135135,736812,46359,2039,11840,0,6770,16417,32404,723396,29833,
tennesse3,736889,357383,379506,41.8,584712,137889,720401,78236,1735,9583,1068,4345,16488,31603,712114,24775,
tennesse4,798482,394578,403904,37.7,613938,118257,776061,76824,2861,14313,266,16834,22421,53007,756725,41757,
tennesse5,777696,376734,400962,35.0,613750,97098,758442,190935,1173,25828,852,24721,19254,75284,679471,98225,
tennesse6,784725,388328,396397,40.8,607353,138856,764412,36384,1507,7195,593,11154,20313,34953,755490,29235,
tennesse7,786523,388697,397826,37.9,591027,116325,768011,81711,4170,16825,1669,6718,18512,41102,754055,32468,
tennesse8,699385,341210,358175,41.3,539101,124434,685397,132504,2134,15446,0,5288,13988,26572,670115,29270,
tennesse9,712723,334835,377888,33.9,535351,88573,701423,479340,1117,12314,74,20336,11300,49961,670849,41874,
texas1,352392,373163,37.0,547720,120273,711118,125469,3590,9682,874,9216,14437,132292,666974,58581,
texas2,803041,395581,407460,35.3,599725,95769,785768,104364,3093,61941,288,85581,17273,253375,643848,159193,
texas3,899784,443593,456191,37.4,668954,101408,873965,90453,4334,151334,154,22972,25819,135640,692689,207095,
texas4,759648,375616,384032,39.4,572626,126918,739424,84201,5608,9424,56,26424,20224,114300,712715,46933,
texas5,749808,375687,374121,35.9,552533,103839,731478,118355,3988,13423,471,30494,18330,218116,639934,109874,
texas6,804816,392405,412411,35.4,596930,93745,771387,173170,5190,40475,785,35065,33429,184231,709540,95276,
texas7,775198,369140,406058,35.2,578901,84625,750738,118712,4713,88329,452,53747,24460,234636,534530,240668,
texas8,871420,441580,429840,37.5,651553,120514,850212,71309,2727,27241,367,22294,21208,208341,758980,112440,
texas9,786925,390386,396539,33.1,587430,80357,772928,298391,2319,93502,227,112833,13997,307972,517640,269285,
texas10,896798,446389,450409,35.9,671283,115433,866850,96895,6400,56253,255,71815,29948,256821,747427,149371,
texas11,782337,395795,386542,35.2,583052,123087,765271,32729,6674,9738,298,39328,17066,305407,713061,69276,
texas12,812102,395387,416715,35.9,615593,105145,787566,69789,5536,32593,1222,34625,24536,190147,730217,81885,
texas13,711672,362295,349377,36.3,534828,108808,693431,41595,5395,16293,861,23173,18241,196867,645329,66343,
texas14,763380,385859,377521,37.1,577835,106186,742196,149184,2489,23569,1184,24467,21184,194378,682394,80986,
texas15,795511,392834,402677,30.7,554280,85941,781572,17538,1876,9974,9,69565,13939,645358,616835,178676,
texas16,733764,364458,369306,32.5,537128,91704,709522,25247,2619,10354,1246,95537,24242,595345,562561,171203,
texas17,793513,391197,402316,32.3,607071,98336,775225,102109,3110,42096,373,11538,18288,210482,698343,95170,
texas18,801885,403768,398117,32.5,593816,76522,785432,288465,3717,31511,1622,72098,16453,343799,623465,178420,
texas19,731759,368432,363327,33.3,548562,100356,709715,45575,6035,13229,580,43292,22044,276461,669194,62565,
texas20,846337,418716,427621,31.6,619922,93978,819929,46037,8866,25393,310,40498,26408,595290,719306,127031,
texas21,818281,402703,415578,37.9,662092,131351,788445,32770,2881,29039,732,27933,29836,236012,738233,80048,
texas22,935386,466242,469144,36.3,676882,104393,912325,136922,2278,181244,107,33809,23061,254441,688161,247225,
texas23,794879,402774,392105,34.6,578864,105863,779300,30583,4834,19335,788,56224,15579,548671,659599,135280,
texas24,817147,399073,418074,36.0,628127,91697,793472,110412,3351,117466,1797,47511,23675,203656,604464,212683,
texas25,786976,396266,390710,37.2,599483,115659,761319,69290,3302,28624,306,22396,25657,149693,724197,62779,
texas26,894192,444110,450082,35.4,660558,90210,858042,78576,7743,68168,590,21757,36150,169223,778858,115334,
texas27,739719,364530,375189,36.8,555181,118955,724879,41344,2329,11994,648,35602,14840,396568,674485,65234,
texas28,768719,372334,396385,31.7,530987,89807,752446,32159,1070,5791,145,31281,16273,602429,617514,151205,
texas29,765435,391147,374288,31.0,537017,64441,755887,70548,4281,13968,645,107513,9548,612292,512007,253428,
texas30,804679,391249,413430,32.7,576166,86687,789648,336430,2283,14962,413,31025,15031,318402,660113,144566,
texas31,883347,435632,447715,35.2,654667,106381,841318,109176,2772,47493,2160,20875,42029,221869,781612,101735,
texas32,769852,377037,392815,35.8,599247,95901,747596,102562,6032,72675,277,46780,22256,202062,585295,184557,
texas33,777745,393163,384582,30.5,540569,68640,760877,122972,4995,17897,701,152322,16868,524674,520463,257282,
texas34,727688,366631,361057,33.5,514468,101984,720293,7703,1723,5342,166,34347,7395,618938,588171,139517,
texas35,818369,414562,403807,33.1,625785,83304,794048,70848,7018,14993,157,96876,24321,505374,681744,136625,
texas36,754178,371221,382957,37.0,562526,111382,734233,75145,4826,15512,197,18632,19945,205282,673922,80256,
utah1,391666,385244,31.1,542040,82802,752805,10269,8207,11260,2742,18326,24105,100753,735919,40991,
utah2,779772,395806,383966,33.0,571202,104260,755184,9845,9239,18207,8365,64551,24588,123282,707283,72489,
utah3,773622,389039,384583,28.4,545758,85042,749779,7338,10730,15232,8159,15397,23843,83614,715644,57978,
utah4,830801,415946,414855,31.3,570274,79193,802186,12913,6502,31199,10096,73182,28615,142571,731037,99764,
vermont1,308118,318181,43.1,510772,123875,613514,7621,1743,11859,139,2815,12785,12450,595486,30813,
virginia1,402022,411856,38.6,619403,123912,779581,132600,2333,27329,377,30862,34297,97345,738726,75152,
virginia2,743410,368693,374717,36.2,585280,112245,706976,149840,2357,44229,479,18438,36434,63771,676387,67023,
virginia3,744804,362348,382456,34.9,577378,100426,711396,340644,2653,22057,684,15163,33408,47779,701997,42807,
virginia4,747291,362363,384928,38.7,596774,115128,724861,306710,1588,13221,343,7770,22430,43787,706895,40396,
virginia5,739410,362094,377316,42.8,594390,150340,714747,140674,1832,14640,145,3402,24663,25036,707762,31648,
virginia6,755437,366278,389159,39.9,603009,141158,732326,86070,1610,12942,101,6810,23111,44633,713502,41935,
virginia7,812385,395800,416585,39.3,622337,128234,780305,155347,1925,40821,448,18065,32080,60656,734712,77673,
virginia8,795467,390982,404485,36.2,629953,96724,757054,121753,1744,91310,949,37495,38413,141997,570896,224571,
virginia9,704831,351127,353704,43.5,576130,145820,694577,36880,1624,11649,648,3036,10254,14305,689571,15260,
virginia10,862308,431724,430584,38.4,634862,108403,818266,57551,1581,138104,682,27634,44042,117246,668976,193332,
virginia11,798464,397307,401157,36.7,608529,95835,748092,103443,3018,139120,803,47068,50372,156255,543185,255279,
washington1,386186,382177,38.2,583516,101663,733450,10649,9426,92675,1210,25332,34913,68076,640703,127660,
washington2,755546,374958,380588,38.2,608636,125330,708856,23666,8211,74185,3994,25951,46690,87379,638100,117446,
washington3,743322,368445,374877,40.2,572266,128758,702615,9261,8275,23483,5570,17874,40707,73378,679702,63620,
washington4,735031,370322,364709,34.0,522903,103987,704403,11227,19925,13040,559,107163,30628,292354,608745,126286,
washington5,725964,359510,366454,37.9,571894,125841,692018,11197,12465,18559,3826,14465,33946,49583,681003,44961,
washington6,731742,370118,361624,41.5,588529,147594,676670,23020,13441,32278,5372,10233,55072,57204,681358,50384,
washington7,799589,404348,395241,36.0,675465,114120,745373,32500,3442,104256,2594,22680,54216,62587,655406,144183,
washington8,754721,373342,381379,39.0,571491,102853,707376,23330,8189,71094,4732,39906,47345,85384,640592,114129,
washington9,765285,386508,378777,36.7,601309,103032,716158,97348,5106,178518,12410,55554,49127,101779,534981,230304,
washington10,756028,373122,382906,35.7,577643,110809,696039,49610,8849,53693,13657,25695,59989,92629,670151,85877,
west_virginia1,302832,303304,41.8,490837,120219,594423,16341,833,5765,13,1988,11713,7663,597540,8596,
west_virginia2,624120,308616,315504,42.7,492074,120355,610895,28834,1352,5377,269,3319,13225,13528,610287,13833,
west_virginia3,575576,283209,292367,44.0,459696,120642,566103,23504,444,2317,169,1123,9473,4378,570400,5176,
wisconsin1,357055,360661,41.1,555953,118576,698696,40798,1898,13495,262,13767,19020,72096,678473,39243,
wisconsin2,768067,381487,386580,36.9,607943,115716,743552,33402,3727,33480,194,12207,24515,51357,712478,55589,
wisconsin3,724568,364060,360508,39.0,574559,129906,710705,7846,3486,17386,142,7457,13863,20380,705087,19481,
wisconsin4,710573,343598,366975,32.9,532098,86994,679706,234575,3294,31139,268,59336,30867,127197,639358,71215,
wisconsin5,731341,358554,372787,41.3,576328,132502,717464,21218,2076,24913,158,9253,13877,42129,690610,40731,
wisconsin6,714886,361506,353380,41.9,565783,132131,701406,15080,3448,17053,123,5516,13480,33423,690802,24084,
wisconsin7,710420,357492,352928,44.7,558681,144611,696490,5661,13419,12134,538,4104,13930,17298,692143,18277,
wisconsin8,735997,367530,368467,40.7,570118,126047,719036,12052,19016,15780,276,9835,16961,39953,706689,29308,
wyoming1,292619,285118,38.5,444641,96557,564021,3667,16185,5807,1111,8798,13716,57895,560209,17528,
